REB = "countries/Rebels.txt"
AAC = "countries/Aachen.txt"
ABB = "countries/Dongola.txt"
ABE = "countries/Abenaki.txt"
ABI = "countries/Abihka.txt"
ACH = "countries/PrincipalityOfAchaia.txt"
ACO = "countries/Acoma.txt"
ADA = "countries/Adal.txt"
ADE = "countries/Aden.txt"
ADU = "countries/Andalusia.txt"
AFA = "countries/Afar.txt"
AFG = "countries/Afghanistan.txt"
AGG = "countries/Attigneenongnahac.txt"
AGQ = "countries/Algonquin.txt"
AHM = "countries/Ahmadnagar.txt"
AIR = "countries/Air.txt"
AJU = "countries/Ajuuraan.txt"
AKK = "countries/AkKoyunlu.txt"
AKM = "countries/Akamatsu.txt"
AKS = "countries/Aksumite Empire.txt"
AKT = "countries/Ando.txt"
ALA = "countries/Alaska.txt"
ALB = "countries/Albania.txt"
ALE = "countries/Alencon.txt"
ALG = "countries/Algiers.txt"
ALH = "countries/Haasa.txt"
ALO = "countries/Alodia.txt"
ALS = "countries/Alsace.txt"
ALT = "countries/Altamaha.txt"
AMA = "countries/Amago.txt"
AMG = "countries/Armagnac.txt"
ANH = "countries/Anhalt.txt"
ANL = "countries/Anilco.txt"
ANN = "countries/Annam.txt"
ANS = "countries/Ansbach.txt"
ANT = "countries/Antemoro.txt"
ANU = "countries/Ainu.txt"
ANZ = "countries/Anizah.txt"
AOT = "countries/Aotearoa.txt"
APA = "countries/Apache.txt"
AQU = "countries/Aquileia.txt"
ARA = "countries/Aragon.txt"
ARB = "countries/Arabia.txt"
ARD = "countries/Ardalan.txt"
ARK = "countries/Arakan.txt"
ARL = "countries/Ardabil.txt"
ARM = "countries/Armenia.txt"
ARN = "countries/Arendaronon.txt"
ARP = "countries/Arapaho.txt"
ARW = "countries/Arawak.txt"
ASA = "countries/Asakura.txt"
ASH = "countries/Ashanti.txt"
ASI = "countries/Assiniboine.txt"
ASK = "countries/Ashikaga.txt"
ASS = "countries/Assam.txt"
AST = "countries/Astrakhan.txt"
ASU = "countries/Asturias.txt"
ATA = "countries/Atahachi.txt"
ATH = "countries/Athens.txt"
ATJ = "countries/Atjeh.txt"
ATT = "countries/Attignawantan.txt"
ATW = "countries/Attiwandaron.txt"
AUG = "countries/Augsburg.txt"
AUS = "countries/Australia.txt"
AUV = "countries/Auvergne.txt"
AVA = "countries/Ava.txt"
AVE = "countries/AngevinEmpire.txt"
AVI = "countries/Avignon.txt"
AVR = "countries/Avars.txt"
AWN = "countries/Awngthim.txt"
AYD = "countries/Aydin.txt"
AYU = "countries/Ayutthaya.txt"
AZT = "countries/Aztec.txt"
BAD = "countries/Baden.txt"
BAH = "countries/Bahmanis.txt"
BAL = "countries/Baluchistan.txt"
BAM = "countries/Bamberg.txt"
BAN = "countries/Banten.txt"
BAR = "countries/Bar.txt"
BAV = "countries/Bavaria.txt"
BDA = "countries/Baroda.txt"
BEI = "countries/Brunei.txt"
BEJ = "countries/Beja.txt"
BEN = "countries/Benin.txt"
BER = "countries/Berry.txt"
BEU = "countries/Berau.txt"
BGA = "countries/Baglana.txt"
BGL = "countries/Bagelkhand.txt"
BHA = "countries/Bharat.txt"
BHT = "countries/Bohtan.txt"
BHU = "countries/Bhutan.txt"
BIJ = "countries/Bijapur.txt"
BLA = "countries/Blackfoot.txt"
BLG = "countries/Bologna.txt"
BLI = "countries/Bali.txt"
BLM = "countries/Blambangan.txt"
BLO = "countries/Beloozero.txt"
BND = "countries/Bundelkhand.txt"
BNE = "countries/Bone.txt"
BNG = "countries/Bengal.txt"
BNJ = "countries/Banjar.txt"
BNY = "countries/Bunyoro.txt"
BOH = "countries/Bohemia.txt"
BON = "countries/Bonoman.txt"
BOS = "countries/Bosnia.txt"
BOU = "countries/Bourbonnais.txt"
BPI = "countries/Biapas.txt"
BPR = "countries/Prome.txt"
BRA = "countries/Brandenburg.txt"
BRB = "countries/Brabant.txt"
BRE = "countries/Bremen.txt"
BRG = "countries/Berg.txt"
BRI = "countries/Brittany.txt"
BRR = "countries/Berar.txt"
BRS = "countries/Barus.txt"
BRT = "countries/Buryats.txt"
BRU = "countries/Brunswick.txt"
BRZ = "countries/Brazil.txt"
BSG = "countries/Basoga.txt"
BSH = "countries/Bashkiria.txt"
BSR = "countries/Basra.txt"
BST = "countries/Bastar.txt"
BTI = "countries/Semien.txt"
BTL = "countries/Bitlis.txt"
BTN = "countries/Buton.txt"
BTS = "countries/Betsimisaraka.txt"
BTU = "countries/Butuan.txt"
BUG = "countries/Buganda.txt"
BUK = "countries/Bukhara.txt"
BUL = "countries/Bulgaria.txt"
BUR = "countries/Burgundy.txt"
BUU = "countries/Burundi.txt"
BYT = "countries/Bayreuth.txt"
BYZ = "countries/ByzantineEmpire.txt"
CAB = "countries/Carib.txt"
CAD = "countries/Caddo.txt"
CAL = "countries/California.txt"
CAM = "countries/UPCA.txt"
CAN = "countries/Canada.txt"
CAO = "countries/Cahokia.txt"
CAQ = "countries/Casqui.txt"
CAS = "countries/Castille.txt"
CAT = "countries/Catalunya.txt"
CAY = "countries/Cayuga.txt"
CBA = "countries/Chiba.txt"
CCA = "countries/Chisca.txt"
CCM = "countries/Chichimeca.txt"
CCQ = "countries/Calchaqui.txt"
CDL = "countries/Dali.txt"
CEB = "countries/Cebu.txt"
CEP = "countries/Corfu.txt"
CEY = "countries/Ceylon.txt"
CGS = "countries/Changsheng.txt"
CHA = "countries/Champa.txt"
CHC = "countries/Chu.txt"
CHD = "countries/Chanda.txt"
CHE = "countries/Cherokee.txt"
CHG = "countries/ChagataiKhanate.txt"
CHH = "countries/Chahar.txt"
CHI = "countries/Chickasaw.txt"
CHK = "countries/Champassak.txt"
CHL = "countries/Chile.txt"
CHM = "countries/Chimu.txt"
CHO = "countries/Choctaw.txt"
CHP = "countries/Champagne.txt"
CHR = "countries/Chernigov.txt"
CHT = "countries/Chorti.txt"
CHU = "countries/Chukchi.txt"
CHV = "countries/Chavchuveny.txt"
CHY = "countries/Cheyenne.txt"
CIA = "countries/Chiaha.txt"
CIR = "countries/Circassia.txt"
CJA = "countries/Cajamarca.txt"
CKW = "countries/Chokwe.txt"
CLA = "countries/Colla.txt"
CLB = "countries/Calenberg.txt"
CLG = "countries/Chalahgawtha.txt"
CLI = "countries/Cilli.txt"
CLM = "countries/Colima.txt"
CMI = "countries/Miao.txt"
CMP = "countries/RewaKantha.txt"
CND = "countries/Candar.txt"
CNK = "countries/Chinook.txt"
CNN = "countries/Connacht.txt"
CNP = "countries/Can Pech.txt"
COB = "countries/Coburg.txt"
COC = "countries/Cocomes.txt"
COF = "countries/Cofitachequi.txt"
COI = "countries/Coixtlahuaca.txt"
COL = "countries/Colombia.txt"
COM = "countries/Comanche.txt"
COO = "countries/Coosa.txt"
COR = "countries/Corsica.txt"
COW = "countries/Coweta.txt"
CRA = "countries/Charca.txt"
CRB = "countries/Cirebon.txt"
CRE = "countries/Creek.txt"
CRI = "countries/Crimea.txt"
CRN = "countries/Cornwall.txt"
CRO = "countries/Croatia.txt"
CRT = "countries/Crete.txt"
CSC = "countries/Cascadia.txt"
CSH = "countries/Shun.txt"
CSK = "countries/Chosokabe.txt"
CSU = "countries/Cusco.txt"
CTM = "countries/Chactemal.txt"
CUA = "countries/Charrua.txt"
CUB = "countries/Cuba.txt"
CXI = "countries/Xi.txt"
CYA = "countries/Chachapoya.txt"
CYI = "countries/Yi.txt"
CYP = "countries/Cyprus.txt"
CZH = "countries/Zhou.txt"
DAH = "countries/Dahomey.txt"
DAI = "countries/DaiViet.txt"
DAL = "countries/Dalmatia.txt"
DAM = "countries/Damot.txt"
DAN = "countries/Denmark.txt"
DAR = "countries/Darfur.txt"
DAU = "countries/Dauphine.txt"
DAW = "countries/Dawasir.txt"
DEC = "countries/Deccan.txt"
DGB = "countries/Dagbon.txt"
DGL = "countries/Maldives.txt"
DHU = "countries/Dhundhar.txt"
DLH = "countries/Delhi.txt"
DLI = "countries/Deli.txt"
DMK = "countries/Demak.txt"
DMS = "countries/Desmond.txt"
DNG = "countries/Dang.txt"
DNZ = "countries/Danzig.txt"
DTE = "countries/Date.txt"
DTI = "countries/Doti.txt"
DTT = "countries/Dithmarschen.txt"
DUL = "countries/Dulkadir.txt"
DWT = "countries/Donauwoerth.txt"
EDE = "countries/Edese.txt"
EFR = "countries/EastFrisia.txt"
EGY = "countries/Egypt.txt"
EIC = "countries/EastIndiaCompany.txt"
EJZ = "countries/EastJianzhou.txt"
ENA = "countries/Eneara.txt"
ENG = "countries/England.txt"
EOR = "countries/Eora.txt"
EPI = "countries/Epirus.txt"
ERE = "countries/Eretna.txt"
ERI = "countries/Erie.txt"
ERS = "countries/Eranshahr.txt"
EST = "countries/Estonia.txt"
ETH = "countries/Ethiopia.txt"
ETO = "countries/Etowah.txt"
ETR = "countries/Etruria.txt"
FAD = "countries/Fadl.txt"
FEO = "countries/Theodoro.txt"
FER = "countries/Ferrara.txt"
FEZ = "countries/Fez.txt"
FIN = "countries/Finland.txt"
FKN = "countries/Franconia.txt"
FLA = "countries/Flanders.txt"
FLO = "countries/Florida.txt"
FLY = "countries/Faly.txt"
FOI = "countries/Foix.txt"
FOX = "countries/Fox.txt"
FRA = "countries/France.txt"
FRI = "countries/Friesland.txt"
FRM = "countries/Formosa.txt"
FRN = "countries/Frankfurt.txt"
FRS = "countries/Fars.txt"
FRT = "countries/Ferrartea.txt"
FUL = "countries/Fulo.txt"
FZA = "countries/Fezzan.txt"
GAL = "countries/Galicia.txt"
GAM = "countries/Guamar.txt"
GAZ = "countries/Gazikumukh.txt"
GBR = "countries/GreatBritain.txt"
GDW = "countries/Gondwana.txt"
GEL = "countries/Gelre.txt"
GEN = "countries/Genoa.txt"
GEO = "countries/Georgia.txt"
GER = "countries/Germany.txt"
GHD = "countries/Ghadames.txt"
GHR = "countries/Garhwal.txt"
GLE = "countries/Geledi.txt"
GLG = "countries/Glogau.txt"
GLH = "countries/GoldenHorde.txt"
GMI = "countries/Gamilaraay.txt"
GNG = "countries/Gingee.txt"
GNV = "countries/Geneva.txt"
GOC = "countries/Golconda.txt"
GOL = "countries/GreatHorde.txt"
GOS = "countries/Goslar.txt"
GOT = "countries/Gotland.txt"
GRA = "countries/Granada.txt"
GRE = "countries/Greece.txt"
GRJ = "countries/Garjat.txt"
GRK = "countries/Gorkha.txt"
GRM = "countries/Germiyan.txt"
GUA = "countries/Guarani.txt"
GUG = "countries/Guge.txt"
GUJ = "countries/Gujarat.txt"
GUR = "countries/Gurma.txt"
GUY = "countries/Gascony.txt"
GWA = "countries/Gwalior.txt"
GZI = "countries/Great Zimbabwe.txt"
HAB = "countries/Austria.txt"
HAD = "countries/Hadoti.txt"
HAI = "countries/Hainaut.txt"
HAM = "countries/Hamburg.txt"
HAN = "countries/Hannover.txt"
HAR = "countries/Harar.txt"
HAT = "countries/Haiti.txt"
HAU = "countries/Hausa.txt"
HAW = "countries/Hawaii.txt"
HDA = "countries/Haida.txt"
HDR = "countries/Hadramut.txt"
HDY = "countries/Hadiya.txt"
HED = "countries/Hedjaz.txt"
HES = "countries/Hessen.txt"
HIN = "countries/Hindustan.txt"
HJA = "countries/Huyla.txt"
HJO = "countries/Hojo.txt"
HLR = "countries/HolyRomanEmpire.txt"
HMI = "countries/Karadel.txt"
HNI = "countries/Hasinai.txt"
HOB = "countries/Hobyo.txt"
HOD = "countries/Hodyntsy.txt"
HOL = "countries/Holland.txt"
HRS = "countries/Harsanos.txt"
HRZ = "countries/Herzegovina.txt"
HSA = "countries/Hansa.txt"
HSC = "countries/Highlands.txt"
HSE = "countries/Hsenwi.txt"
HSI = "countries/Hsipaw.txt"
HSK = "countries/Hosokawa.txt"
HSN = "countries/Ayyubids.txt"
HST = "countries/Huastec.txt"
HTK = "countries/Hatakeyama.txt"
HUA = "countries/Huai.txt"
HUN = "countries/Hungary.txt"
HUR = "countries/Huron.txt"
HWK = "countries/Hathawekela.txt"
ICE = "countries/Iceland.txt"
ICH = "countries/Ichisi.txt"
ICM = "countries/Ichma.txt"
IDR = "countries/Idar.txt"
IKE = "countries/Ikeda.txt"
ILI = "countries/Illinois.txt"
ILK = "countries/Ilkhanate.txt"
ILL = "countries/Illinewek.txt"
IME = "countries/Imereti.txt"
IMG = "countries/Imagawa.txt"
INC = "countries/Inca.txt"
IND = "countries/Indrapura.txt"
ING = "countries/Ingolstadt.txt"
INN = "countries/Innu.txt"
IRE = "countries/Ireland.txt"
IRN = "countries/Ihranum.txt"
IRO = "countries/Iroquois.txt"
IRQ = "countries/Iraq.txt"
ISF = "countries/Isfahan.txt"
ISK = "countries/Isshiki.txt"
ISL = "countries/Isleta.txt"
ITA = "countries/Italy.txt"
ITO = "countries/Ito.txt"
ITZ = "countries/Itza.txt"
JAI = "countries/Malta.txt"
JAJ = "countries/Janjira.txt"
JAN = "countries/Jangladesh.txt"
JAP = "countries/Japan.txt"
JAR = "countries/Jarai.txt"
JFN = "countries/Jaffna.txt"
JGD = "countries/Junagarh.txt"
JIM = "countries/Jima.txt"
JIN = "countries/Jin.txt"
JJI = "countries/Janjero.txt"
JLV = "countries/Jhalavad.txt"
JMB = "countries/Jambi.txt"
JML = "countries/Jumla.txt"
JMN = "countries/Jan Mayen.txt"
JNN = "countries/Jenne.txt"
JNP = "countries/Jaunpur.txt"
JOA = "countries/Joara.txt"
JOH = "countries/Johor.txt"
JOL = "countries/Jolof.txt"
JPR = "countries/Jeypore.txt"
JSL = "countries/Jaisalmer.txt"
KAA = "countries/Kauai.txt"
KAC = "countries/Kachar.txt"
KAF = "countries/Kaffa.txt"
KAL = "countries/Kale.txt"
KAM = "countries/Mdokhams.txt"
KAN = "countries/Kano.txt"
KAQ = "countries/Kaqchikel.txt"
KAR = "countries/Karaman.txt"
KAS = "countries/Yarkand.txt"
KAT = "countries/Kathiawar.txt"
KAU = "countries/Kaurna.txt"
KAZ = "countries/Kazan.txt"
KBA = "countries/Kabylia.txt"
KBO = "countries/KanemBornu.txt"
KBU = "countries/Kaabu.txt"
KED = "countries/Kedah.txt"
KEL = "countries/Kelantan.txt"
KER = "countries/Keres.txt"
KGR = "countries/Kangra.txt"
KHA = "countries/MongolKhanate.txt"
KHD = "countries/Khandesh.txt"
KHI = "countries/Khiva.txt"
KHM = "countries/Khmer.txt"
KHO = "countries/Khorasan.txt"
KIC = "countries/Kiche.txt"
KID = "countries/Kildare.txt"
KIE = "countries/Kiev.txt"
KIK = "countries/Kikondja.txt"
KIO = "countries/Kiowa.txt"
KIT = "countries/Kitara.txt"
KJH = "countries/Keonhjar.txt"
KKC = "countries/Kikuchi.txt"
KLD = "countries/Kalundwe.txt"
KLE = "countries/Kleves.txt"
KLH = "countries/Kalahandi.txt"
KLK = "countries/Khalkha.txt"
KLM = "countries/Kalmyk.txt"
KLN = "countries/Keladi.txt"
KLP = "countries/Kalpi.txt"
KLT = "countries/Kolathunad.txt"
KMC = "countries/Kamchadals.txt"
KMN = "countries/Kumaon.txt"
KMT = "countries/Koch.txt"
KND = "countries/Kandy.txt"
KNG = "countries/Kong.txt"
KNI = "countries/Knights.txt"
KNO = "countries/Kono.txt"
KNZ = "countries/Konstanz.txt"
KOC = "countries/Kochin.txt"
KOH = "countries/Koho.txt"
KOI = "countries/Mann.txt"
KOJ = "countries/Jerusalem.txt"
KOK = "countries/Kokkand.txt"
KOL = "countries/Cologne.txt"
KON = "countries/Kongo.txt"
KOR = "countries/Korea.txt"
KRA = "countries/Krakow.txt"
KRC = "countries/Khorchin.txt"
KRK = "countries/Carnatic.txt"
KRL = "countries/Karelia.txt"
KRM = "countries/Kerman.txt"
KRW = "countries/Karagwe.txt"
KRY = "countries/Gilan.txt"
KSD = "countries/Khoshuud.txt"
KSH = "countries/Kashmir.txt"
KSI = "countries/Kasihta.txt"
KSJ = "countries/Kasanje.txt"
KSK = "countries/Kaskaskia.txt"
KSP = "countries/Kispoko.txt"
KTB = "countries/Kitabatake.txt"
KTS = "countries/Katsina.txt"
KTU = "countries/Kathmandu.txt"
KUB = "countries/Kuba.txt"
KUL = "countries/Kulin.txt"
KUR = "countries/Kurland.txt"
KUT = "countries/Kutai.txt"
KZB = "countries/Kazembe.txt"
KZH = "countries/Kazakh.txt"
LAC = "countries/Lacandon.txt"
LAE = "countries/Latin Empire.txt"
LAI = "countries/Lau.txt"
LAK = "countries/Lakota.txt"
LAN = "countries/Florence.txt"
LAP = "countries/LaPlata.txt"
LAR = "countries/Larrakia.txt"
LAU = "countries/Lauenburg.txt"
LBV = "countries/Landshut.txt"
LDK = "countries/Ladakh.txt"
LDU = "countries/Lundu.txt"
LEB = "countries/Lebanon.txt"
LEI = "countries/Leinster.txt"
LEN = "countries/Lenape.txt"
LFA = "countries/Lanfang.txt"
LIB = "countries/Libertatia.txt"
LIE = "countries/Liege.txt"
LIG = "countries/Ligor.txt"
LIP = "countries/Lipan.txt"
LIT = "countries/Lithuania.txt"
LIV = "countries/LivonianOrder.txt"
LNA = "countries/LanNa.txt"
LND = "countries/Lunda.txt"
LNG = "countries/Liang.txt"
LNO = "countries/Lanao.txt"
LOA = "countries/Loango.txt"
LOI = "countries/TheIsles.txt"
LON = "countries/Leon.txt"
LOR = "countries/Lorraine.txt"
LOT = "countries/Lotharingia.txt"
LOU = "countries/Louisiana.txt"
LPP = "countries/Lippe.txt"
LRI = "countries/Luristan.txt"
LTG = "countries/Latgalia.txt"
LUA = "countries/LuangPrabang.txt"
LUB = "countries/Luba.txt"
LUC = "countries/Lucca.txt"
LUN = "countries/Luneburg.txt"
LUW = "countries/Luwu.txt"
LUX = "countries/Luxembourg.txt"
LVA = "countries/Livonia.txt"
LWA = "countries/Limbuwan.txt"
LXA = "countries/LanXang.txt"
MAA = "countries/Mataatua.txt"
MAB = "countries/Malabar.txt"
MAD = "countries/Madurai.txt"
MAE = "countries/Maeda.txt"
MAG = "countries/Magdeburg.txt"
MAH = "countries/Mahican.txt"
MAI = "countries/Mainz.txt"
MAJ = "countries/Majapahit.txt"
MAK = "countries/Makuria.txt"
MAL = "countries/Mali.txt"
MAM = "countries/Burgi.txt"
MAN = "countries/Mantua.txt"
MAR = "countries/Marathas.txt"
MAS = "countries/Madyaas.txt"
MAT = "countries/Matlatzinca.txt"
MAU = "countries/Maui.txt"
MAW = "countries/Marwar.txt"
MAY = "countries/Maya.txt"
MAZ = "countries/Mazovia.txt"
MBA = "countries/Mombasa.txt"
MBL = "countries/Bishnupur.txt"
MBZ = "countries/Montfort-Bregenz.txt"
MCA = "countries/Muisca.txt"
MCH = "countries/Manchu.txt"
MCM = "countries/MacCarthy.txt"
MDA = "countries/Medina.txt"
MDI = "countries/Mogadishu.txt"
MED = "countries/Medri Bahri.txt"
MEI = "countries/Meissen.txt"
MEM = "countries/Memmingen.txt"
MEN = "countries/Mentese.txt"
MER = "countries/Mewar.txt"
MEW = "countries/Mewat.txt"
MEX = "countries/Mexico.txt"
MFA = "countries/Montferrat.txt"
MFL = "countries/Mikhlaf.txt"
MFY = "countries/Mahafaly.txt"
MGD = "countries/Maguindanao.txt"
MGE = "countries/MongolEmpire.txt"
MGR = "countries/Maregh.txt"
MHR = "countries/Mahra.txt"
MHX = "countries/Haixi.txt"
MIA = "countries/Mianjin.txt"
MIK = "countries/Mikmaq.txt"
MIN = "countries/Min.txt"
MIR = "countries/Merina.txt"
MIS = "countries/Miskito.txt"
MIX = "countries/Mixtec.txt"
MJE = "countries/Majeerteen.txt"
MJO = "countries/Majorca.txt"
MJZ = "countries/Jianzhou.txt"
MKA = "countries/MongKawng.txt"
MKL = "countries/Mecklenburg.txt"
MKP = "countries/Makwanpur.txt"
MKS = "countries/Makassar.txt"
MKU = "countries/Makua.txt"
MLB = "countries/Manipur.txt"
MLC = "countries/Malacca.txt"
MLG = "countries/Malagana.txt"
MLH = "countries/Mulhouse.txt"
MLI = "countries/Malindi.txt"
MLK = "countries/Kashen.txt"
MLO = "countries/Milan.txt"
MLS = "countries/Maliseet.txt"
MLW = "countries/Malwa.txt"
MMA = "countries/MongMao.txt"
MMI = "countries/Miami.txt"
MNA = "countries/Maynila.txt"
MND = "countries/Mendebalde.txt"
MNG = "countries/Ming.txt"
MNI = "countries/MongNai.txt"
MNS = "countries/IRE_Munster.txt"
MOD = "countries/Modena.txt"
MOE = "countries/Morea.txt"
MOH = "countries/Mohawk.txt"
MOL = "countries/Moldavia.txt"
MON = "countries/Montenegro.txt"
MOR = "countries/Morocco.txt"
MOS = "countries/Muscowy.txt"
MPA = "countries/MongPai.txt"
MPC = "countries/Mapuche.txt"
MPH = "countries/MuanPhuang.txt"
MRA = "countries/Maravi.txt"
MRE = "countries/Marehan.txt"
MRI = "countries/Mori.txt"
MRK = "countries/Marrakesh.txt"
MSA = "countries/Malaya.txt"
MSC = "countries/Mescalero.txt"
MSG = "countries/Mississage.txt"
MSI = "countries/Mossi.txt"
MSY = "countries/Mushashaiyyah.txt"
MTH = "countries/Meath.txt"
MTR = "countries/Mataram.txt"
MUG = "countries/Mughal.txt"
MUL = "countries/Multan.txt"
MUN = "countries/Munster.txt"
MVA = "countries/Moravia.txt"
MYA = "countries/MongYang.txt"
MYR = "countries/Yeren.txt"
MYS = "countries/Mysore.txt"
MZB = "countries/Mzab.txt"
NAG = "countries/Nagpur.txt"
NAH = "countries/Navajo.txt"
NAJ = "countries/Najd.txt"
NAK = "countries/Nakawe.txt"
NAP = "countries/Naples.txt"
NAT = "countries/Natives.txt"
NAV = "countries/Navarra.txt"
NAX = "countries/Naxos.txt"
NBI = "countries/Nubia.txt"
NDO = "countries/Ndongo.txt"
NED = "countries/Netherlands.txt"
NEH = "countries/Nehiyaw.txt"
NEV = "countries/Nevers.txt"
NGA = "countries/Nagaur.txt"
NGP = "countries/Jharkhand.txt"
NHX = "countries/NorthHaixi.txt"
NJR = "countries/Najran.txt"
NKO = "countries/Nkore.txt"
NNG = "countries/Ning.txt"
NOG = "countries/Nogai.txt"
NOL = "countries/Northumberland.txt"
NOO = "countries/Noongar.txt"
NOR = "countries/Norway.txt"
NOV = "countries/Novgorod.txt"
NPL = "countries/Nepal.txt"
NRM = "countries/Normandy.txt"
NSA = "countries/Nassau.txt"
NSS = "countries/New Providence.txt"
NTC = "countries/Natchitoches.txt"
NTZ = "countries/Natchez.txt"
NUB = "countries/Funj.txt"
NUM = "countries/Nuremberg.txt"
NUP = "countries/Nupe.txt"
NVK = "countries/Nivkh.txt"
NVR = "countries/Navanagar.txt"
NZH = "countries/NizhnyNovgorod.txt"
NZL = "countries/Zealandia.txt"
OAH = "countries/Oahu.txt"
ODA = "countries/Oda.txt"
ODH = "countries/Oudh.txt"
OEO = "countries/Oneota.txt"
OGD = "countries/Ogaadeen.txt"
OGS = "countries/Ogasawara.txt"
OHK = "countries/Ohkay Owingeh.txt"
OIR = "countries/OiratHorde.txt"
OJI = "countries/Ojibwa.txt"
OKA = "countries/Oka.txt"
OLD = "countries/Oldenburg.txt"
OMA = "countries/Oman.txt"
ONE = "countries/Oneida.txt"
ONO = "countries/Onondaga.txt"
OPL = "countries/Opole.txt"
ORD = "countries/Ormond.txt"
ORI = "countries/Orissa.txt"
ORL = "countries/Orleans.txt"
ORM = "countries/Ormuz.txt"
OSA = "countries/Osage.txt"
OSH = "countries/Osheaga.txt"
OSN = "countries/Osnabruck.txt"
OTM = "countries/Otomo.txt"
OTO = "countries/Otomi.txt"
OTT = "countries/Ottawa.txt"
OUC = "countries/Ouchi.txt"
OYO = "countries/Oyo.txt"
PAD = "countries/Paderborn.txt"
PAH = "countries/Pahang.txt"
PAL = "countries/Palatinate.txt"
PAN = "countries/Panna.txt"
PAP = "countries/Papal.txt"
PAR = "countries/Parma.txt"
PAT = "countries/Pattani.txt"
PAW = "countries/Pawnee.txt"
PCH = "countries/Pacaha.txt"
PCJ = "countries/Pacajes.txt"
PDV = "countries/Padova.txt"
PEG = "countries/Pegu.txt"
PEN = "countries/Penobscot.txt"
PEO = "countries/Peoria.txt"
PEQ = "countries/Pequot.txt"
PER = "countries/Persia.txt"
PEU = "countries/Peru.txt"
PGA = "countries/Perugia.txt"
PGR = "countries/Pagarruyung.txt"
PGS = "countries/Pangasinan.txt"
PHA = "countries/Phagmodrupa.txt"
PIC = "countries/Picardy.txt"
PIM = "countries/Pima.txt"
PIR = "countries/Pirates.txt"
PIS = "countries/Pisa.txt"
PLB = "countries/Palembang.txt"
PLC = "countries/TheCommonwealth.txt"
PLT = "countries/Polotsk.txt"
PLW = "countries/Palawa.txt"
POL = "countries/Poland.txt"
POM = "countries/Pommerania.txt"
POR = "countries/Portugal.txt"
POT = "countries/Potawatomi.txt"
POW = "countries/Powhatan.txt"
PRB = "countries/Porbandar.txt"
PRD = "countries/Parlakhimidi.txt"
PRG = "countries/Paraguay.txt"
PRK = "countries/Perak.txt"
PRM = "countries/Perm.txt"
PRO = "countries/Provence.txt"
PRU = "countries/Prussia.txt"
PRY = "countries/Port Royal.txt"
PSA = "countries/Pasai.txt"
PSK = "countries/Pskov.txt"
PSS = "countries/Passau.txt"
PTA = "countries/Patiala.txt"
PTE = "countries/Pate.txt"
PTG = "countries/Potiguara.txt"
PTL = "countries/Palitana.txt"
PTT = "countries/Patna.txt"
PUE = "countries/Pueblo.txt"
PUN = "countries/Punjab.txt"
QAR = "countries/QaraKoyunlu.txt"
QAS = "countries/QasimKhanate.txt"
QIC = "countries/Qi.txt"
QIN = "countries/Qin.txt"
QNG = "countries/Qing.txt"
QOM = "countries/Qom.txt"
QTO = "countries/Quito.txt"
QUE = "countries/Quebec.txt"
QUI = "countries/Quizquiz.txt"
RAG = "countries/Ragusa.txt"
RAM = "countries/Ramazan.txt"
RAS = "countries/Rassids.txt"
REG = "countries/Regensburg.txt"
RFR = "countries/Nanbu.txt"
RHA = "countries/Rhade.txt"
RIG = "countries/Riga.txt"
RJK = "countries/Rajkot.txt"
RJP = "countries/Rajputana.txt"
RMN = "countries/Romania.txt"
RMP = "countries/Rohilkandh.txt"
ROM = "countries/RomanEmpire.txt"
ROT = "countries/Rothenburg.txt"
RSO = "countries/Rostov.txt"
RTT = "countries/Ratanpur.txt"
RUG = "countries/Rugen.txt"
RUM = "countries/Rum.txt"
RUP = "countries/Ruppin.txt"
RUS = "countries/Russia.txt"
RVA = "countries/Ravensburg.txt"
RWA = "countries/Rwanda.txt"
RYA = "countries/Ryazan.txt"
RYS = "countries/Ryssadirum.txt"
RYU = "countries/Ryukyu.txt"
RZI = "countries/Rozwi.txt"
RZW = "countries/Butua.txt"
SAK = "countries/Siak.txt"
SAL = "countries/Salish.txt"
SAM = "countries/Samoa.txt"
SAR = "countries/Sardinia.txt"
SAT = "countries/Satapo.txt"
SAV = "countries/Savoy.txt"
SAX = "countries/Saxony.txt"
SBA = "countries/Shiba.txt"
SBP = "countries/Sambalpur.txt"
SCA = "countries/Scandinavia.txt"
SCO = "countries/Scotland.txt"
SDY = "countries/Sadiya.txt"
SEN = "countries/Seneca.txt"
SER = "countries/Serbia.txt"
SFA = "countries/SofalaSwa.txt"
SHA = "countries/Shawnee.txt"
SHL = "countries/Holstein.txt"
SHM = "countries/Shammar.txt"
SHN = "countries/Shoni.txt"
SHO = "countries/Shoshone.txt"
SHR = "countries/Sharjah.txt"
SHU = "countries/Shu.txt"
SHY = "countries/Shaybanid.txt"
SIA = "countries/Siam.txt"
SIB = "countries/Sibir.txt"
SIC = "countries/Sicily.txt"
SIE = "countries/Siena.txt"
SIL = "countries/Silesia.txt"
SIO = "countries/Sioux.txt"
SIS = "countries/Sistan.txt"
SKA = "countries/Sakalava.txt"
SKK = "countries/Sikkim.txt"
SLE = "countries/Sale.txt"
SLN = "countries/Sligo.txt"
SLO = "countries/Slovakia.txt"
SLZ = "countries/Salzburg.txt"
SMB = "countries/Sambas.txt"
SME = "countries/Samtskhe.txt"
SMI = "countries/Sami.txt"
SMO = "countries/Smolensk.txt"
SMZ = "countries/Shimazu.txt"
SNA = "countries/Sonora.txt"
SND = "countries/Sind.txt"
SOA = "countries/Shewa.txt"
SOF = "countries/Sofala.txt"
SOK = "countries/Sokoto.txt"
SOL = "countries/Solon.txt"
SOM = "countries/Somalia.txt"
SON = "countries/Songhai.txt"
SOO = "countries/So.txt"
SOR = "countries/Sorbia.txt"
SOS = "countries/Sus.txt"
SPA = "countries/Spain.txt"
SPI = "countries/SardiniaPiedmont.txt"
SPL = "countries/Spoleto.txt"
SRG = "countries/Surguja.txt"
SRH = "countries/Sirhind.txt"
SRM = "countries/Sirmur.txt"
SRS = "countries/Surastrania.txt"
SRU = "countries/Saruhan.txt"
SRV = "countries/Shirvanshah.txt"
SST = "countries/Shan.txt"
STA = "countries/Stadacona.txt"
STE = "countries/Stettin.txt"
STK = "countries/Satake.txt"
STY = "countries/Styria.txt"
SUK = "countries/Sukhothai.txt"
SUL = "countries/Sulu.txt"
SUN = "countries/Sunda.txt"
SUS = "countries/Susquehannock.txt"
SWA = "countries/Swabia.txt"
SWE = "countries/Sweden.txt"
SWI = "countries/Schweiz.txt"
SYG = "countries/Sarigyogir.txt"
SYN = "countries/Synthetics.txt"
SYO = "countries/Soyo.txt"
SYR = "countries/Syria.txt"
SZO = "countries/Saluzzo.txt"
TAB = "countries/Tabarestan.txt"
TAH = "countries/Tahontaenrat.txt"
TAI = "countries/Tairona.txt"
TAK = "countries/Takitimu.txt"
TAN = "countries/Tainui.txt"
TAR = "countries/Tarascan.txt"
TAU = "countries/Taungu.txt"
TBK = "countries/Tumbuka.txt"
TBR = "countries/Tabriz.txt"
TDO = "countries/Tondo.txt"
TEA = "countries/TeArawa.txt"
TEN = "countries/Tenkodogo.txt"
TEO = "countries/Teotitlan.txt"
TER = "countries/Ternate.txt"
TET = "countries/Tetouan.txt"
TEU = "countries/Teutonicorder.txt"
TEX = "countries/Texas.txt"
TFL = "countries/Tafilalt.txt"
TGT = "countries/Touggourt.txt"
THL = "countries/Thule.txt"
THU = "countries/Thuringia.txt"
TIB = "countries/Tibet.txt"
TID = "countries/Tidore.txt"
TIM = "countries/Timurid.txt"
TIO = "countries/Tionontate.txt"
TIR = "countries/Tirol.txt"
TIW = "countries/Tiwi.txt"
TKD = "countries/Takeda.txt"
TKG = "countries/Tokugawa.txt"
TKI = "countries/Toki.txt"
TLA = "countries/Tlapanec.txt"
TLC = "countries/Tlemcen.txt"
TLG = "countries/Telingana.txt"
TLX = "countries/Tlaxcala.txt"
TMB = "countries/Timbuktu.txt"
TNG = "countries/Tang.txt"
TNJ = "countries/Tanjore.txt"
TNK = "countries/Taranaki.txt"
TNT = "countries/Trent.txt"
TOG = "countries/Tonga.txt"
TOK = "countries/Tonkin.txt"
TON = "countries/Tonallan.txt"
TOR = "countries/Tortuga.txt"
TOT = "countries/Totonac.txt"
TOU = "countries/Toulouse.txt"
TPA = "countries/Tupinamba.txt"
TPQ = "countries/Tupiniquim.txt"
TPR = "countries/Tripura.txt"
TRA = "countries/Transylvania.txt"
TRE = "countries/Trebizond.txt"
TRI = "countries/Trier.txt"
TRP = "countries/Tripoli.txt"
TRS = "countries/Transoxiana.txt"
TRT = "countries/Tirhut.txt"
TRY = "countries/Tyrconnell.txt"
TSC = "countries/Tuscarora.txt"
TTI = "countries/Tsutsui.txt"
TTL = "countries/Three Leagues.txt"
TTS = "countries/Two Sicilies.txt"
TTT = "countries/TeTaiTokerau.txt"
TUA = "countries/Tapuia.txt"
TUN = "countries/Tunisia.txt"
TUR = "countries/Ottomans.txt"
TUS = "countries/Tuscany.txt"
TVE = "countries/Tver.txt"
TXT = "countries/Textosagi.txt"
TYO = "countries/Tyo.txt"
TYR = "countries/Tyrone.txt"
UBH = "countries/Buha.txt"
UBV = "countries/Munich.txt"
UES = "countries/Uesugi.txt"
UHW = "countries/HawaiiUnited.txt"
UKR = "countries/Ukraine.txt"
ULM = "countries/Ulm.txt"
ULS = "countries/Ulster.txt"
URB = "countries/Urbino.txt"
USA = "countries/USA.txt"
UTN = "countries/Utsunomiya.txt"
UTR = "countries/Utrecht.txt"
UTS = "countries/Utsang.txt"
VAL = "countries/Valencia.txt"
VEN = "countries/Venice.txt"
VER = "countries/Verden.txt"
VIE = "countries/Vientiane.txt"
VIJ = "countries/Vijaynagara.txt"
VIL = "countries/Viti Levu.txt"
VIT = "countries/Viti.txt"
VND = "countries/Venad.txt"
VNL = "countries/Vanua Levu.txt"
VNZ = "countries/Venezuela.txt"
VOL = "countries/Volyn.txt"
VRM = "countries/Vermont.txt"
VRN = "countries/Verona.txt"
W00 = "countries/c_valois.txt"
W01 = "countries/c_vargashi.txt"
W02 = "countries/c_varmland.txt"
W03 = "countries/c_vastvag.txt"
W04 = "countries/c_vasyugan.txt"
W05 = "countries/c_vaucouleurs.txt"
W06 = "countries/c_velsk.txt"
W07 = "countries/c_vermandois.txt"
W08 = "countries/c_vestfold.txt"
W09 = "countries/c_vestisland.txt"
W0A = "countries/c_viipuri.txt"
W0B = "countries/c_vijnot.txt"
W0C = "countries/c_vingulmork.txt"
W0D = "countries/c_vitim.txt"
W0E = "countries/c_vladimir.txt"
W0F = "countries/c_voin.txt"
W0G = "countries/c_volkovysk.txt"
W0H = "countries/c_volodymyr.txt"
W0I = "countries/c_vologda.txt"
W0J = "countries/c_wa.txt"
W0K = "countries/c_wadai.txt"
W0L = "countries/c_wakhan.txt"
W0M = "countries/c_wakhsh.txt"
W0N = "countries/c_wallen.txt"
W0O = "countries/c_wandala.txt"
W0P = "countries/c_warri.txt"
W0Q = "countries/c_warzazat.txt"
W0R = "countries/c_wassa.txt"
W0S = "countries/c_welamo.txt"
W0T = "countries/c_wellega.txt"
W0U = "countries/c_wenyon.txt"
W0V = "countries/c_werle.txt"
W0W = "countries/c_west_kordofan.txt"
W0X = "countries/c_wielunska.txt"
W0Y = "countries/c_worodugu.txt"
W0Z = "countries/c_wuli.txt"
W10 = "countries/c_yabrin.txt"
W11 = "countries/c_yaitsk.txt"
W12 = "countries/c_yako.txt"
W13 = "countries/c_yalala.txt"
W14 = "countries/c_yangjibaliq.txt"
W15 = "countries/c_yanokul.txt"
W16 = "countries/c_yar-calli.txt"
W17 = "countries/c_yaroslavl.txt"
W18 = "countries/c_yasin.txt"
W19 = "countries/c_yatvyagi.txt"
W1A = "countries/c_yau.txt"
W1B = "countries/c_yauri.txt"
W1C = "countries/c_yekaterinburg.txt"
W1D = "countries/c_yelimane.txt"
W1E = "countries/c_yendi.txt"
W1F = "countries/c_yenisei.txt"
W1G = "countries/c_yoshkar-ola.txt"
W1H = "countries/c_zachlumia.txt"
W1I = "countries/c_zakroczymska.txt"
W1J = "countries/c_zamfara.txt"
W1K = "countries/c_zammour.txt"
W1L = "countries/c_zamora.txt"
W1M = "countries/c_zamtam.txt"
W1N = "countries/c_zarafshan.txt"
W1O = "countries/c_zaran.txt"
W1P = "countries/c_zarma.txt"
W1Q = "countries/c_zaslavl.txt"
W1R = "countries/c_zawila.txt"
W1S = "countries/c_zelengora.txt"
W1T = "countries/c_zirkuh.txt"
W1U = "countries/c_znojmo.txt"
W1V = "countries/c_zurich.txt"
W1W = "countries/c_zutphen.txt"
WAD = "countries/Wadai.txt"
WAI = "countries/Waitaha.txt"
WAL = "countries/Wallachia.txt"
WAM = "countries/Wampanoag.txt"
WAR = "countries/Warsangali.txt"
WBG = "countries/Wurzburg.txt"
WCR = "countries/Cree.txt"
WCY = "countries/Wichiyena.txt"
WEN = "countries/Wenro.txt"
WES = "countries/Westfalia.txt"
WGD = "countries/Wagadugu.txt"
WIC = "countries/Wichita.txt"
WKA = "countries/Wanka.txt"
WLS = "countries/Wales.txt"
WLY = "countries/Welayta.txt"
WOL = "countries/Wolgast.txt"
WRU = "countries/Wurundjeri.txt"
WSI = "countries/WestIndies.txt"
WUR = "countries/Wurttemberg.txt"
WUU = "countries/Wu.txt"
X00 = "countries/c_mareeg.txt"
X01 = "countries/c_mark.txt"
X02 = "countries/c_marsabit.txt"
X03 = "countries/c_martyuba.txt"
X04 = "countries/c_masa.txt"
X05 = "countries/c_masabadhan.txt"
X06 = "countries/c_masalit.txt"
X07 = "countries/c_massina.txt"
X08 = "countries/c_mau.txt"
X09 = "countries/c_mayo.txt"
X0A = "countries/c_mearns.txt"
X0B = "countries/c_meaux.txt"
X0C = "countries/c_medelpad.txt"
X0D = "countries/c_medjerda.txt"
X0F = "countries/c_mema.txt"
MNR = "countries/Armanaric.txt"
X0H = "countries/c_metz.txt"
X0I = "countries/c_miastko.txt"
X0J = "countries/c_minyanka.txt"
X0K = "countries/c_mondonedo.txt"
X0L = "countries/c_monkh_saridag.txt"
X0M = "countries/c_monmouthshire.txt"
X0N = "countries/c_montaigu.txt"
X0O = "countries/c_montargis.txt"
X0P = "countries/c_monterrei.txt"
X0Q = "countries/c_morarna.txt"
X0R = "countries/c_moura.txt"
X0S = "countries/c_mozhaysk.txt"
X0T = "countries/c_mumo.txt"
X0U = "countries/c_munda.txt"
X0V = "countries/c_munio.txt"
X0W = "countries/c_munjan.txt"
X0X = "countries/c_murom.txt"
X0Y = "countries/c_murzuk.txt"
X0Z = "countries/c_mustasaari.txt"
X10 = "countries/c_naga.txt"
X11 = "countries/c_najera.txt"
X12 = "countries/c_nakhshab.txt"
X13 = "countries/c_nalu.txt"
X14 = "countries/c_namandiru.txt"
X15 = "countries/c_namdalfylki.txt"
X16 = "countries/c_namur.txt"
X17 = "countries/c_nancy.txt"
X18 = "countries/c_nandana.txt"
X19 = "countries/c_nanumba.txt"
X1A = "countries/c_narim.txt"
X1B = "countries/c_narym_DZU.txt"
X1C = "countries/c_nasaiya.txt"
X1D = "countries/c_nasrabad.txt"
X1E = "countries/c_naumberg.txt"
X1F = "countries/c_naushki.txt"
X1G = "countries/c_ndenye.txt"
X1H = "countries/c_nedenes.txt"
X1I = "countries/c_neramkary.txt"
X1J = "countries/c_neuchatel.txt"
X1K = "countries/c_neufchateau.txt"
X1L = "countries/c_ngoring.txt"
X1M = "countries/c_nicosia.txt"
X1N = "countries/c_niebla.txt"
X1O = "countries/c_ningi.txt"
X1P = "countries/c_niomi.txt"
X1Q = "countries/c_nordmark.txt"
X1R = "countries/c_nordrland.txt"
X1S = "countries/c_norwegian_more.txt"
X1T = "countries/c_novara.txt"
X1U = "countries/c_novgorod_seversky.txt"
X1V = "countries/c_novogrudok.txt"
X1W = "countries/c_nugaal.txt"
X1X = "countries/c_nuon.txt"
X1Y = "countries/c_nurtay.txt"
X1Z = "countries/c_nyene.txt"
X20 = "countries/c_nyland.txt"
X21 = "countries/c_nysa.txt"
X22 = "countries/c_nzi.txt"
X23 = "countries/c_ob.txt"
X24 = "countries/c_odoyev.txt"
X25 = "countries/c_ogoja.txt"
X26 = "countries/c_oigon.txt"
X27 = "countries/c_okangara.txt"
X28 = "countries/c_olavinlinna.txt"
X29 = "countries/c_olkhon.txt"
X2A = "countries/c_olmedo.txt"
X2B = "countries/c_onega_BJA.txt"
X2C = "countries/c_onsthia.txt"
X2D = "countries/c_opanda.txt"
X2E = "countries/c_opava.txt"
X2F = "countries/c_orangallu.txt"
X2H = "countries/c_orenburg.txt"
X2I = "countries/c_orkney.txt"
X2J = "countries/c_oshrusana.txt"
X2K = "countries/c_oudalan.txt"
X2L = "countries/c_oulu.txt"
X2M = "countries/c_oursi.txt"
X2N = "countries/c_oversticht.txt"
X2O = "countries/c_oyo.txt"
X2P = "countries/c_pagania.txt"
X2Q = "countries/c_palniki.txt"
X2R = "countries/c_panjgur.txt"
X2S = "countries/c_pavia.txt"
X2T = "countries/c_peaccam.txt"
X2U = "countries/c_pedersore.txt"
X2V = "countries/c_pedroche.txt"
X2W = "countries/c_pegu.txt"
X2X = "countries/c_pelym.txt"
X2Y = "countries/c_pembrokeshire.txt"
X2Z = "countries/c_pendjari.txt"
X30 = "countries/c_penugonda.txt"
X31 = "countries/c_peremyshl.txt"
X32 = "countries/c_peresopnytsia.txt"
X33 = "countries/c_pereyaslavl.txt"
X34 = "countries/c_petropavl.txt"
X35 = "countries/c_petropavolsk.txt"
X36 = "countries/c_pielinen.txt"
X37 = "countries/c_pila.txt"
X38 = "countries/c_pindiga.txt"
X39 = "countries/c_pinsk.txt"
X3A = "countries/c_plocka.txt"
X3B = "countries/c_po.txt"
X3C = "countries/c_polovragi.txt"
X3D = "countries/c_pomorje.txt"
X3E = "countries/c_povenets.txt"
X3F = "countries/c_pravia.txt"
X3G = "countries/c_prenzlau.txt"
X3H = "countries/c_pudozh.txt"
X3I = "countries/c_pura.txt"
X3J = "countries/c_puttlingen.txt"
X3K = "countries/c_putyvl.txt"
X3L = "countries/c_qain.txt"
X3M = "countries/c_qalaafe.txt"
X3N = "countries/c_qalaat.txt"
X3O = "countries/c_qaryatan.txt"
X3P = "countries/c_qashtiliya.txt"
X3Q = "countries/c_qatif.txt"
X3R = "countries/c_qimr.txt"
X3S = "countries/c_qinggil.txt"
X3T = "countries/c_qumarleb.txt"
X3U = "countries/c_quriltay.txt"
X3V = "countries/c_qus.txt"
X3W = "countries/c_quzlum.txt"
X3X = "countries/c_radomska.txt"
X3Y = "countries/c_rajrappa.txt"
X3Z = "countries/c_ranikot.txt"
X40 = "countries/c_ras_hafun.txt"
X41 = "countries/c_reims.txt"
X42 = "countries/c_renandu.txt"
X43 = "countries/c_rethel.txt"
X44 = "countries/c_riqan.txt"
X45 = "countries/c_rogalandi.txt"
X46 = "countries/c_romen.txt"
X47 = "countries/c_ronda.txt"
X48 = "countries/c_roslavl.txt"
X49 = "countries/c_rostock.txt"
X4A = "countries/c_rounala.txt"
X4B = "countries/c_ryty.txt"
X4C = "countries/c_saalum.txt"
X4D = "countries/c_saarbrucken.txt"
X4E = "countries/c_sabakyul.txt"
X4F = "countries/c_sacz.txt"
X4G = "countries/c_sagiz.txt"
X4H = "countries/c_sakmara.txt"
X4I = "countries/c_salaga.txt"
X4J = "countries/c_salamanca.txt"
X4K = "countries/c_salamat.txt"
X4L = "countries/c_salavat.txt"
X4M = "countries/c_samander.txt"
X4N = "countries/c_samar_VB.txt"
X4O = "countries/c_samarkand.txt"
X4P = "countries/c_samarra.txt"
X4Q = "countries/c_samiran.txt"
X4R = "countries/c_samman.txt"
X4S = "countries/c_sancerre.txt"
X4T = "countries/c_sanda.txt"
X4U = "countries/c_sandomierska.txt"
X4V = "countries/c_sanij.txt"
X4W = "countries/c_santiago.txt"
X4X = "countries/c_saoura.txt"
X4Y = "countries/c_sartlan.txt"
X4Z = "countries/c_satfura.txt"
X50 = "countries/c_satif.txt"
X51 = "countries/c_savalu.txt"
X52 = "countries/c_say.txt"
X53 = "countries/c_scalovia.txt"
X54 = "countries/c_sefrou.txt"
SLC = "countries/Seleukeia.txt"
X56 = "countries/c_semey.txt"
X57 = "countries/c_seno.txt"
X58 = "countries/c_sens.txt"
X59 = "countries/c_sersou.txt"
X5A = "countries/c_severin.txt"
X5B = "countries/c_sevilla.txt"
X5C = "countries/c_sevsk.txt"
X5D = "countries/c_sfax.txt"
X5E = "countries/c_shahrazur.txt"
X5F = "countries/c_shahre-babak.txt"
X5G = "countries/c_sharka.txt"
X5H = "countries/c_sharkiya.txt"
X5I = "countries/c_shavgar.txt"
X5J = "countries/c_shchuchinsk.txt"
X5K = "countries/c_shenkursk.txt"
X5L = "countries/c_sherbro.txt"
X5M = "countries/c_shetland.txt"
X5N = "countries/c_shishina.txt"
X5O = "countries/c_shityy.txt"
X5P = "countries/c_shorkot.txt"
X5Q = "countries/c_showa.txt"
X5R = "countries/c_shughnan.txt"
X5S = "countries/c_sibi_mali.txt"
X5T = "countries/c_sidamo.txt"
X5U = "countries/c_sieradzka.txt"
X5V = "countries/c_sif-i-umara.txt"
X5W = "countries/c_siggevara.txt"
X5X = "countries/c_sighnaq.txt"
X5Y = "countries/c_sijilmasa.txt"
X5Z = "countries/c_sikasso.txt"
X60 = "countries/c_silla.txt"
X61 = "countries/c_siracusa.txt"
X62 = "countries/c_sirhan.txt"
X63 = "countries/c_sirjan.txt"
X64 = "countries/c_sirwan.txt"
X65 = "countries/c_sitti.txt"
X66 = "countries/c_siwistan.txt"
X67 = "countries/c_skolt.txt"
X68 = "countries/c_slupsk.txt"
X69 = "countries/c_slutsk.txt"
X6A = "countries/c_sochur.txt"
X6B = "countries/c_sog.txt"
X6C = "countries/c_sogn.txt"
X6D = "countries/c_sokode.txt"
X6E = "countries/c_soldin.txt"
X6F = "countries/c_solimana.txt"
X6G = "countries/c_sombio.txt"
X6H = "countries/c_sonda.txt"
X6I = "countries/c_soria.txt"
X6J = "countries/c_sorok.txt"
X6K = "countries/c_sortavala.txt"
X6L = "countries/c_soso.txt"
X6M = "countries/c_sosva.txt"
X6N = "countries/c_souf.txt"
X6O = "countries/c_sousse.txt"
X6P = "countries/c_south_kordofan.txt"
X6Q = "countries/c_spreewald.txt"
X6R = "countries/c_sravasti.txt"
X6S = "countries/c_srihatta.txt"
X6T = "countries/c_starodub.txt"
X6U = "countries/c_stezycka.txt"
X6V = "countries/c_stoenesti.txt"
X6W = "countries/c_strassburg.txt"
X6X = "countries/c_strathearn.txt"
X6Y = "countries/c_suakin.txt"
X6Z = "countries/c_subay.txt"
X70 = "countries/c_sudurland.txt"
X71 = "countries/c_suenik.txt"
X72 = "countries/c_suondavara.txt"
X73 = "countries/c_surparaka.txt"
X74 = "countries/c_suzdal.txt"
X75 = "countries/c_sysma.txt"
X76 = "countries/c_tabarqa.txt"
X77 = "countries/c_tabary.txt"
X78 = "countries/c_tabassa.txt"
X79 = "countries/c_tabon.txt"
X7A = "countries/c_tadjoura.txt"
X7B = "countries/c_tadla.txt"
X7C = "countries/c_tagant.txt"
X7D = "countries/c_taghaza.txt"
X7E = "countries/c_tagul.txt"
X7F = "countries/c_tahert.txt"
X7G = "countries/c_tahoua.txt"
X7H = "countries/c_taif.txt"
X7I = "countries/c_takkeda.txt"
X7J = "countries/c_takon.txt"
X7K = "countries/c_takrit.txt"
X7L = "countries/c_tala.txt"
X7M = "countries/c_tamentit.txt"
X7N = "countries/c_tamiso.txt"
X7O = "countries/c_tangiers.txt"
X7P = "countries/c_tara.txt"
X7Q = "countries/c_targu_jiu.txt"
X7R = "countries/c_targyl.txt"
X7S = "countries/c_tarnowska.txt"
X7T = "countries/c_tartas_SIB.txt"
X7U = "countries/c_tarvagatai.txt"
X7V = "countries/c_taskyl.txt"
X7W = "countries/c_tavan_bogd.txt"
X7X = "countries/c_tavasts.txt"
X7Y = "countries/c_taza.txt"
X7Z = "countries/c_tbilisi.txt"
X80 = "countries/c_teke.txt"
X81 = "countries/c_telemark.txt"
X82 = "countries/c_temne.txt"
X83 = "countries/c_ter.txt"
X84 = "countries/c_terebovl.txt"
X85 = "countries/c_terektai.txt"
X86 = "countries/c_tesiin_gol.txt"
X87 = "countries/c_thalabiya.txt"
X88 = "countries/c_thouars.txt"
X89 = "countries/c_tibesti.txt"
X8A = "countries/c_tichitt.txt"
X8B = "countries/c_tigheci.txt"
X8C = "countries/c_timbi.txt"
X8D = "countries/c_timmoun.txt"
X8E = "countries/c_tindouf.txt"
X8F = "countries/c_tinmallal.txt"
X8G = "countries/c_tmutarakan.txt"
X8H = "countries/c_tobol.txt"
X8I = "countries/c_toksun.txt"
X8J = "countries/c_tokumbay.txt"
X8K = "countries/c_toma.txt"
X8L = "countries/c_tomsk.txt"
X8M = "countries/c_tonnerrois.txt"
X8N = "countries/c_torangy_kul.txt"
X8O = "countries/c_torema.txt"
X8P = "countries/c_torne.txt"
X8Q = "countries/c_toro.txt"
X8R = "countries/c_tortona.txt"
X8S = "countries/c_torun.txt"
X8T = "countries/c_totma.txt"
X8U = "countries/c_touat.txt"
X8V = "countries/c_trandheim.txt"
X8W = "countries/c_travunia.txt"
X8X = "countries/c_trigarta.txt"
X8Y = "countries/c_troyes.txt"
X8Z = "countries/c_tsaparang.txt"
X90 = "countries/c_tudela.txt"
X91 = "countries/c_tudgha.txt"
X92 = "countries/c_tui.txt"
X93 = "countries/c_tula.txt"
X94 = "countries/c_tuluchezeva.txt"
X95 = "countries/c_tulun.txt"
X96 = "countries/c_tumak.txt"
X97 = "countries/c_tun.txt"
X98 = "countries/c_tunis.txt"
X99 = "countries/c_turan.txt"
X9A = "countries/c_turin.txt"
X9B = "countries/c_turuberan.txt"
X9C = "countries/c_tyendugu.txt"
X9D = "countries/c_tyumen.txt"
X9E = "countries/c_ubins.txt"
X9F = "countries/c_ufa.txt"
X9G = "countries/c_uiska.txt"
X9H = "countries/c_ulaanbaatar.txt"
X9I = "countries/c_ulaangom.txt"
X9J = "countries/c_uliastai.txt"
X9K = "countries/c_uliuty.txt"
X9L = "countries/c_umiai.txt"
X9M = "countries/c_upper_bono.txt"
X9N = "countries/c_upper_gurma.txt"
X9O = "countries/c_uqayr.txt"
X9P = "countries/c_uraltau.txt"
X9Q = "countries/c_urgamal.txt"
X9R = "countries/c_urhobo.txt"
X9S = "countries/c_ushmun.txt"
X9T = "countries/c_ushytsia.txt"
X9U = "countries/c_ustyug.txt"
X9V = "countries/c_uulynkhol.txt"
X9W = "countries/c_uvs_nuur.txt"
X9X = "countries/c_uwal.txt"
X9Y = "countries/c_uzgend_KARA.txt"
X9Z = "countries/c_valladolid.txt"
XAL = "countries/Xalisco.txt"
XIU = "countries/Xiu.txt"
Y00 = "countries/c_cantillana.txt"
CRD = "countries/Ceredigion.txt"
Y02 = "countries/c_carmarthenshire.txt"
Y03 = "countries/c_carmona.txt"
Y04 = "countries/c_cea.txt"
Y05 = "countries/c_cetatea_alba.txt"
Y06 = "countries/c_chadrinsk.txt"
Y07 = "countries/c_chaghaniyan.txt"
Y08 = "countries/c_chalon.txt"
Y09 = "countries/c_chalons.txt"
Y0A = "countries/c_charkliq.txt"
Y0B = "countries/c_cheboksary.txt"
Y0C = "countries/c_chelabinsk.txt"
Y0D = "countries/c_cherven.txt"
Y0E = "countries/c_chich.txt"
Y0F = "countries/c_chilia.txt"
Y0G = "countries/c_choklema.txt"
Y0H = "countries/c_chuguchak.txt"
Y0I = "countries/c_chulym.txt"
Y0J = "countries/c_chuna.txt"
Y0K = "countries/c_chuya.txt"
Y0L = "countries/c_clermont.txt"
Y0M = "countries/c_colmar.txt"
Y0N = "countries/c_comares.txt"
Y0O = "countries/c_como.txt"
Y0P = "countries/c_cordoba.txt"
Y0Q = "countries/c_coruna.txt"
Y0R = "countries/c_coulommiers.txt"
Y0S = "countries/c_craiova.txt"
Y0T = "countries/c_cremona.txt"
Y0U = "countries/c_cykma.txt"
Y0V = "countries/c_czerska.txt"
Y0W = "countries/c_dabou.txt"
Y0X = "countries/c_dabusiya.txt"
Y0Y = "countries/c_dadigar.txt"
Y0Z = "countries/c_dagon.txt"
Y10 = "countries/c_dakajalan.txt"
Y11 = "countries/c_damagaram.txt"
Y12 = "countries/c_damergu.txt"
Y13 = "countries/c_damin_i_koh.txt"
Y14 = "countries/c_danakil.txt"
Y15 = "countries/c_dar-al-rih.txt"
Y16 = "countries/c_dar_al-said.txt"
Y17 = "countries/c_dar_sila.txt"
Y18 = "countries/c_daura.txt"
Y19 = "countries/c_dawaro.txt"
Y1A = "countries/c_debul.txt"
Y1B = "countries/c_degelen.txt"
Y1C = "countries/c_dendi.txt"
Y1D = "countries/c_deqen.txt"
Y1E = "countries/c_derbent.txt"
Y1F = "countries/c_devin.txt"
Y1G = "countries/c_dhankar.txt"
Y1H = "countries/c_dhofar.txt"
Y1I = "countries/c_diamare.txt"
Y1J = "countries/c_dibri.txt"
Y1K = "countries/c_dihistan.txt"
Y1L = "countries/c_dijon.txt"
Y1M = "countries/c_dipalpur.txt"
Y1N = "countries/c_djaba.txt"
Y1O = "countries/c_djado.txt"
Y1P = "countries/c_djanet.txt"
Y1Q = "countries/c_djerba.txt"
Y1R = "countries/c_dobrzynska.txt"
Y1S = "countries/c_dokwi.txt"
Y1T = "countries/c_dole.txt"
Y1U = "countries/c_dolgujar.txt"
Y1V = "countries/c_dorohychyn.txt"
Y1W = "countries/c_dortmund.txt"
Y1X = "countries/c_draa.txt"
Y1Y = "countries/c_durovka.txt"
Y1Z = "countries/c_dyamare.txt"
Y20 = "countries/c_dyulaso.txt"
Y21 = "countries/c_east_darfur.txt"
Y22 = "countries/c_east_kiilt.txt"
Y23 = "countries/c_edd.txt"
Y24 = "countries/c_el_fasher.txt"
Y25 = "countries/c_el_waak.txt"
Y26 = "countries/c_elvas.txt"
Y27 = "countries/c_emil.txt"
Y28 = "countries/c_ennis.txt"
Y29 = "countries/c_faereyar.txt"
Y2A = "countries/c_fafan.txt"
Y2B = "countries/c_fahs.txt"
Y2C = "countries/c_fakkan.txt"
Y2D = "countries/c_famagusta.txt"
Y2E = "countries/c_fante.txt"
Y2F = "countries/c_fayyum.txt"
Y2G = "countries/c_fellata.txt"
Y2H = "countries/c_ferghana.txt"
Y2I = "countries/c_fife.txt"
Y2J = "countries/c_fika.txt"
Y2K = "countries/c_firabr.txt"
Y2L = "countries/c_firdafylki.txt"
Y2M = "countries/c_french_leon.txt"
Y2N = "countries/c_fudalhi.txt"
Y2O = "countries/c_fuerteventura.txt"
Y2P = "countries/c_gabal.txt"
Y2Q = "countries/c_galam.txt"
Y2R = "countries/c_galati.txt"
Y2S = "countries/c_gamo.txt"
Y2T = "countries/c_gangaran.txt"
Y2U = "countries/c_garoua.txt"
Y2V = "countries/c_gatsuurgazar.txt"
Y2W = "countries/c_gauldala.txt"
Y2X = "countries/c_gaya.txt"
Y2Y = "countries/c_geba.txt"
Y2Z = "countries/c_ghardaia.txt"
Y30 = "countries/c_ghat.txt"
Y31 = "countries/c_ghazzal.txt"
Y32 = "countries/c_ghulja.txt"
Y33 = "countries/c_gilgit.txt"
Y34 = "countries/c_giurgiu.txt"
Y35 = "countries/c_giza.txt"
Y36 = "countries/c_gobir.txt"
Y37 = "countries/c_gode.txt"
Y38 = "countries/c_gola.txt"
Y39 = "countries/c_golaghmuli.txt"
Y3A = "countries/c_gondo.txt"
Y3B = "countries/c_gonja.txt"
Y3C = "countries/c_gorlitz.txt"
Y3D = "countries/c_gostyninska.txt"
Y3E = "countries/c_gowrie.txt"
Y3F = "countries/c_grebo.txt"
Y3G = "countries/c_groningen.txt"
Y3H = "countries/c_gueguere.txt"
Y3I = "countries/c_guelders.txt"
Y3J = "countries/c_gurgan.txt"
Y3K = "countries/c_gursi.txt"
Y3L = "countries/c_guzkol.txt"
Y3M = "countries/c_gyaitang.txt"
Y3N = "countries/c_hadithat-ana.txt"
Y3O = "countries/c_halych.txt"
Y3P = "countries/c_hama.txt"
Y3Q = "countries/c_hanlan.txt"
Y3R = "countries/c_harhiraa.txt"
Y3S = "countries/c_harjadalen.txt"
Y3T = "countries/c_harrat_rahat.txt"
Y3U = "countries/c_hayq.txt"
Y3V = "countries/c_helgum.txt"
Y3W = "countries/c_hereti.txt"
Y3X = "countries/c_hinthada.txt"
Y3Y = "countries/c_hiraab.txt"
Y3Z = "countries/c_hodh.txt"
Y40 = "countries/c_hodna.txt"
Y41 = "countries/c_hohenau.txt"
Y42 = "countries/c_hombori.txt"
Y43 = "countries/c_homs.txt"
Y44 = "countries/c_hordalandi.txt"
Y45 = "countries/c_hradyzk.txt"
Y46 = "countries/c_hulwan.txt"
Y47 = "countries/c_ibibo.txt"
Y48 = "countries/c_idoma.txt"
Y49 = "countries/c_ifat.txt"
Y4A = "countries/c_ifni.txt"
Y4B = "countries/c_igala.txt"
Y4C = "countries/c_igana.txt"
Y4D = "countries/c_igaran.txt"
Y4E = "countries/c_igbo.txt"
Y4F = "countries/c_ijaw.txt"
Y4G = "countries/c_ikjan.txt"
Y4H = "countries/c_ikwere.txt"
Y4I = "countries/c_ile_de_france.txt"
Y4J = "countries/c_ilga.txt"
Y4K = "countries/c_iligh.txt"
Y4L = "countries/c_iliq.txt"
Y4M = "countries/c_ilo.txt"
Y4N = "countries/c_inari.txt"
Y4O = "countries/c_irkutsk.txt"
Y4P = "countries/c_isfara.txt"
Y4Q = "countries/c_ishim.txt"
Y4R = "countries/c_issoudun.txt"
Y4S = "countries/c_iviza.txt"
Y4T = "countries/c_jabal_kufs.txt"
Y4U = "countries/c_jaligny.txt"
Y4V = "countries/c_jalmat.txt"
Y4W = "countries/c_jalula.txt"
Y4X = "countries/c_jambalar.txt"
Y4Y = "countries/c_jame.txt"
Y4Z = "countries/c_jamtfir.txt"
Y50 = "countries/c_jara.txt"
Y51 = "countries/c_jasky_kart.txt"
Y52 = "countries/c_jebugu.txt"
Y53 = "countries/c_jend.txt"
Y54 = "countries/c_jersika.txt"
Y55 = "countries/c_jihlava.txt"
Y56 = "countries/c_jijil.txt"
Y57 = "countries/c_jilib.txt"
Y58 = "countries/c_jinghiz.txt"
Y59 = "countries/c_jinsko.txt"
Y5A = "countries/c_jiren_suat.txt"
Y5B = "countries/c_jiruft.txt"
Y5C = "countries/c_jovvkuj.txt"
Y5D = "countries/c_jowol.txt"
Y5E = "countries/c_jubba.txt"
Y5F = "countries/c_julevadno.txt"
Y5G = "countries/c_kaarta.txt"
Y5H = "countries/c_kabarasana.txt"
Y5I = "countries/c_kachu.txt"
Y5J = "countries/c_kada.txt"
Y5K = "countries/c_kadam.txt"
Y5L = "countries/c_kaduna.txt"
Y5M = "countries/c_kaffa.txt"
Y5N = "countries/c_kagha.txt"
Y5O = "countries/c_kainuu.txt"
Y5P = "countries/c_kairwan.txt"
Y5Q = "countries/c_kakheti.txt"
Y5R = "countries/c_kakisalmi.txt"
Y5S = "countries/c_kala.txt"
Y5T = "countries/c_kalam.txt"
Y5U = "countries/c_kalat.txt"
Y5V = "countries/c_kalbin.txt"
Y5W = "countries/c_kalyani.txt"
Y5X = "countries/c_kangra.txt"
Y5Y = "countries/c_kaniaga.txt"
Y5Z = "countries/c_kansk.txt"
Y60 = "countries/c_kara_asirgan.txt"
Y61 = "countries/c_kara_khoja.txt"
Y62 = "countries/c_karabaigal.txt"
Y63 = "countries/c_karabalgasun.txt"
Y64 = "countries/c_karabas.txt"
Y65 = "countries/c_karabash.txt"
Y66 = "countries/c_karachev.txt"
Y67 = "countries/c_karamay.txt"
Y68 = "countries/c_karasjohka.txt"
Y69 = "countries/c_karasu.txt"
Y6A = "countries/c_karatayak.txt"
Y6B = "countries/c_karauda.txt"
Y6C = "countries/c_kargadan.txt"
Y6D = "countries/c_kargopol.txt"
Y6E = "countries/c_karkaraly.txt"
Y6F = "countries/c_karran.txt"
Y6G = "countries/c_kasa.txt"
Y6H = "countries/c_kasar_chiki.txt"
Y6I = "countries/c_kash.txt"
Y6J = "countries/c_katagum.txt"
Y6K = "countries/c_kayao.txt"
Y6L = "countries/c_kayor.txt"
Y6M = "countries/c_kazanskoye.txt"
Y6N = "countries/c_kazym.txt"
Y6O = "countries/c_kebbi.txt"
Y6P = "countries/c_keffi.txt"
Y6Q = "countries/c_kera.txt"
Y6R = "countries/c_kermanshah.txt"
Y6S = "countries/c_kevrola.txt"
Y6T = "countries/c_khawr.txt"
Y6U = "countries/c_khentii.txt"
Y6V = "countries/c_khojand.txt"
Y6W = "countries/c_kholmogory.txt"
Y6X = "countries/c_khopyor.txt"
Y6Y = "countries/c_khumar.txt"
Y6Z = "countries/c_kiia.txt"
Y70 = "countries/c_kilba.txt"
Y71 = "countries/c_kinda_sakun.txt"
Y72 = "countries/c_kingui.txt"
Y73 = "countries/c_kintus.txt"
Y74 = "countries/c_kirikongo.txt"
Y75 = "countries/c_kirillov.txt"
Y76 = "countries/c_kishsh.txt"
Y77 = "countries/c_kisi.txt"
Y78 = "countries/c_kita.txt"
Y79 = "countries/c_kitka.txt"
Y7A = "countries/c_kitoi.txt"
Y7B = "countries/c_kittila.txt"
Y7C = "countries/c_kiz.txt"
Y7D = "countries/c_kletsk.txt"
Y7E = "countries/c_koblenz.txt"
Y7F = "countries/c_koda.txt"
Y7G = "countries/c_koi-bagar.txt"
Y7H = "countries/c_kojuk.txt"
Y7I = "countries/c_kokoli.txt"
Y7J = "countries/c_kokpekty.txt"
Y7K = "countries/c_kolobrzeg.txt"
Y7L = "countries/c_kolyvan.txt"
Y7M = "countries/c_komoe.txt"
Y7N = "countries/c_konda_ob.txt"
Y7O = "countries/c_kondoma.txt"
Y7P = "countries/c_kong.txt"
Y7Q = "countries/c_konko.txt"
Y7R = "countries/c_kono.txt"
Y7S = "countries/c_konyan.txt"
Y7T = "countries/c_korgon.txt"
Y7U = "countries/c_koshuki.txt"
Y7V = "countries/c_kotera.txt"
Y7W = "countries/c_kotoko.txt"
Y7X = "countries/c_kozelsk.txt"
Y7Y = "countries/c_krajna.txt"
Y7Z = "countries/c_krasnoyarsk.txt"
Y80 = "countries/c_krems.txt"
Y81 = "countries/c_kropot.txt"
Y82 = "countries/c_kru.txt"
Y83 = "countries/c_kuchuk.txt"
Y84 = "countries/c_kuisugu.txt"
Y85 = "countries/c_kujawy.txt"
Y86 = "countries/c_kuku.txt"
Y87 = "countries/c_kulan_utmas.txt"
Y88 = "countries/c_kulan_uynak.txt"
Y89 = "countries/c_kulunda.txt"
Y8A = "countries/c_kumasi.txt"
Y8B = "countries/c_kuranko.txt"
Y8C = "countries/c_kurgan.txt"
Y8D = "countries/c_kurmina.txt"
Y8E = "countries/c_kursk.txt"
Y8F = "countries/c_kush-murun.txt"
Y8G = "countries/c_kusinagara.txt"
Y8H = "countries/c_kusumi.txt"
Y8I = "countries/c_kuzbas.txt"
Y8J = "countries/c_kwahu-akyem.txt"
Y8K = "countries/c_kwararafa.txt"
Y8L = "countries/c_kyadya.txt"
Y8M = "countries/c_kyin.txt"
Y8N = "countries/c_kymyl_tey.txt"
Y8O = "countries/c_kyunglung.txt"
Y8P = "countries/c_lachyk-uba.txt"
Y8Q = "countries/c_lag_dera.txt"
Y8R = "countries/c_laghwat.txt"
Y8S = "countries/c_laia.txt"
Y8T = "countries/c_landsberg.txt"
Y8U = "countries/c_langres.txt"
Y8V = "countries/c_lara.txt"
Y8W = "countries/c_lecce.txt"
Y8X = "countries/c_leczycka.txt"
Y8Y = "countries/c_lemos.txt"
Y8Z = "countries/c_lena.txt"
Y90 = "countries/c_lepsink.txt"
Y91 = "countries/c_leraba.txt"
Y92 = "countries/c_linlithgowshire.txt"
Y93 = "countries/c_lobi.txt"
Y94 = "countries/c_lobo.txt"
Y95 = "countries/c_lomzynska.txt"
Y96 = "countries/c_lori.txt"
Y97 = "countries/c_loropeni.txt"
Y98 = "countries/c_loulan.txt"
Y99 = "countries/c_lubelska.txt"
Y9A = "countries/c_lubusz.txt"
Y9B = "countries/c_luuq.txt"
Y9C = "countries/c_lviv.txt"
Y9D = "countries/c_lyubim.txt"
Y9E = "countries/c_maastricht.txt"
Y9F = "countries/c_macon.txt"
Y9G = "countries/c_madaya.txt"
Y9H = "countries/c_madeira.txt"
Y9I = "countries/c_madila.txt"
Y9J = "countries/c_madoi.txt"
Y9K = "countries/c_mafaza.txt"
Y9L = "countries/c_magadha.txt"
Y9M = "countries/c_magwe.txt"
Y9N = "countries/c_mahdiya.txt"
Y9O = "countries/c_mait.txt"
Y9P = "countries/c_makhil.txt"
Y9Q = "countries/c_makhir.txt"
Y9R = "countries/c_malaga.txt"
Y9S = "countries/c_mamprusi.txt"
Y9T = "countries/c_man.txt"
Y9U = "countries/c_mana.txt"
Y9V = "countries/c_manatau.txt"
Y9W = "countries/c_mansura.txt"
Y9X = "countries/c_manturovo.txt"
Y9Y = "countries/c_maradi.txt"
Y9Z = "countries/c_marburg.txt"
YAK = "countries/Yaka.txt"
YAN = "countries/Yan.txt"
YAO = "countries/Yao.txt"
YAQ = "countries/Yaqui.txt"
YAR = "countries/Yaroslavl.txt"
YAS = "countries/Yas.txt"
YAT = "countries/Yatenga.txt"
YEM = "countries/Yemen.txt"
YKT = "countries/Yokuts.txt"
YMN = "countries/Yamana.txt"
YNU = "countries/Yanuwa.txt"
YOK = "countries/Yokotan.txt"
YOL = "countries/Yolngu.txt"
YOR = "countries/Andhra.txt"
YUA = "countries/GreatYuan.txt"
YUE = "countries/Yue.txt"
YZD = "countries/Yazd.txt"
Z00 = "countries/k_guiyi.txt"
Z01 = "countries/d_aarjetje.txt"
Z02 = "countries/d_adrar.txt"
Z03 = "countries/d_aksai_chin.txt"
Z04 = "countries/d_aksay.txt"
Z05 = "countries/d_al-wahat.txt"
Z06 = "countries/d_aleppo.txt"
Z07 = "countries/d_alexandria.txt"
Z08 = "countries/d_algarve.txt"
Z09 = "countries/d_amdo.txt"
Z0B = "countries/d_angria.txt"
Z0C = "countries/d_anjou.txt"
Z0D = "countries/d_apulia.txt"
Z0E = "countries/d_aquitaine.txt"
RMC = "countries/Armeniakon.txt"
Z0G = "countries/d_bacs.txt"
Z0H = "countries/d_badajoz.txt"
Z0I = "countries/d_baghdad.txt"
Z0J = "countries/d_balkh.txt"
Z0K = "countries/d_baltiyul.txt"
Z0L = "countries/d_baqlin.txt"
Z0M = "countries/d_barcelona.txt"
Z0N = "countries/d_batang.txt"
Z0O = "countries/d_bazin.txt"
Z0P = "countries/d_beja.txt"
Z0Q = "countries/d_benevento.txt"
Z0R = "countries/d_bhakkar.txt"
Z0S = "countries/d_borgu.txt"
Z0T = "countries/d_boyul.txt"
BKL = "countries/Boukellarion.txt"
Z0V = "countries/d_bukovina.txt"
Z0W = "countries/d_bumthang.txt"
Z0X = "countries/d_cantabria.txt"
Z0Y = "countries/d_cappadocia.txt"
Z0Z = "countries/d_capua.txt"
Z10 = "countries/d_carinthia.txt"
Z11 = "countries/d_chah.txt"
Z12 = "countries/d_chakla.txt"
Z13 = "countries/d_chaldia.txt"
Z15 = "countries/d_chera_nadu.txt"
Z16 = "countries/d_chola_nadu.txt"
KBY = "countries/Kibyrrhaioton.txt"
HLK = "countries/Hilakku.txt"
Z19 = "countries/d_conyi.txt"
Z1A = "countries/d_cyrenaica.txt"
Z1C = "countries/d_daksina_kosala.txt"
Z1D = "countries/d_dalir.txt"
Z1E = "countries/d_damascus.txt"
Z1F = "countries/d_dauria.txt"
Z1G = "countries/d_dege.txt"
DEH = "countries/Deheubarth.txt"
Z1I = "countries/d_delta.txt"
Z1J = "countries/d_diyarbakr.txt"
Z1K = "countries/d_diyarmudar.txt"
Z1L = "countries/d_diyarrabia.txt"
Z1M = "countries/d_dobrudja.txt"
Z1N = "countries/d_don_valley.txt"
Z1O = "countries/d_dzayul.txt"
Z1P = "countries/d_eastern_desert.txt"
EPH = "countries/Ephesos.txt"
Z1S = "countries/d_eweland.txt"
Z1T = "countries/d_figuig.txt"
Z1U = "countries/d_gabes.txt"
Z1V = "countries/d_gainlho.txt"
Z1W = "countries/d_galloway.txt"
Z1X = "countries/d_gauda.txt"
Z1Y = "countries/d_ghur.txt"
Z1Z = "countries/d_gobi_altai.txt"
Z20 = "countries/d_gojjam.txt"
Z21 = "countries/d_golog.txt"
Z22 = "countries/d_gurbantunggut.txt"
GWY = "countries/Wyneddod.txt"
Z24 = "countries/d_gyalrong.txt"
Z25 = "countries/d_gyor.txt"
Z26 = "countries/d_hamadan.txt"
Z27 = "countries/d_herat.txt"
Z28 = "countries/d_ife.txt"
Z29 = "countries/d_itil.txt"
Z2A = "countries/d_jawf-al-yamani.txt"
Z2B = "countries/d_jylland.txt"
Z2C = "countries/d_kabul.txt"
Z2D = "countries/d_kalinga.txt"
Z2E = "countries/d_kalyani.txt"
Z2F = "countries/d_karashar.txt"
Z2G = "countries/d_kargassia.txt"
Z2H = "countries/d_kashgar.txt"
Z2I = "countries/d_kawkaw.txt"
Z2J = "countries/d_khakass_hollow.txt"
Z2K = "countries/d_khotan.txt"
Z2L = "countries/d_khovsgol.txt"
Z2M = "countries/d_khuttal.txt"
Z2N = "countries/d_khuzestan.txt"
Z2O = "countries/d_konda.txt"
Z2P = "countries/d_konkana.txt"
Z2Q = "countries/d_kroumerie.txt"
Z2R = "countries/d_kurmanchal.txt"
Z2S = "countries/d_lanikaz.txt"
Z2T = "countries/d_lata.txt"
Z2U = "countries/d_levedia.txt"
Z2V = "countries/d_lhatok.txt"
Z2W = "countries/d_lhoyul.txt"
Z2X = "countries/d_lingtsang.txt"
Z2Y = "countries/d_litang.txt"
Z2Z = "countries/d_macva.txt"
Z30 = "countries/d_malho.txt"
Z31 = "countries/d_merv.txt"
Z32 = "countries/d_mesopotamia.txt"
Z33 = "countries/d_minsk.txt"
Z34 = "countries/d_monyul.txt"
Z35 = "countries/d_mugodzhar_hills.txt"
Z36 = "countries/d_muluya.txt"
Z37 = "countries/d_murcia.txt"
Z38 = "countries/d_muyunkum.txt"
Z39 = "countries/d_nadia.txt"
Z3A = "countries/d_nagchu.txt"
Z3B = "countries/d_nagormo.txt"
Z3C = "countries/d_nangqen.txt"
Z3D = "countries/d_naqis.txt"
Z3E = "countries/d_nasa.txt"
Z3F = "countries/d_ngamring.txt"
Z3G = "countries/d_nishapur.txt"
Z3H = "countries/d_nordgau.txt"
EAG = "countries/Eastangle.txt"
Z3J = "countries/d_nulambavadi.txt"
Z3K = "countries/d_nyima.txt"
OPS = "countries/Opsikion.txt"
OPT = "countries/Optimaton.txt"
Z3N = "countries/d_ostfalen.txt"
Z3O = "countries/d_ovorkhangai.txt"
Z3P = "countries/d_palmyra.txt"
Z3Q = "countries/d_pandya_nadu.txt"
PPH = "countries/Paphlagonia.txt"
Z3S = "countries/d_philippopolis.txt"
Z3T = "countries/d_poitou.txt"
Z3U = "countries/d_powys.txt"
Z3V = "countries/d_purang.txt"
Z3W = "countries/d_qamdo.txt"
Z3X = "countries/d_rattapadi.txt"
Z3Y = "countries/d_rutog.txt"
Z3Z = "countries/d_sagya.txt"
Z40 = "countries/d_salerno.txt"
Z41 = "countries/d_samogitia.txt"
Z42 = "countries/d_sanaa.txt"
Z43 = "countries/d_saryarka.txt"
Z44 = "countries/d_sebasteia.txt"
Z45 = "countries/d_selenga_valley.txt"
Z46 = "countries/d_sennar.txt"
Z47 = "countries/d_shoria.txt"
Z48 = "countries/d_sinai.txt"
Z49 = "countries/d_sjaelland.txt"
Z4A = "countries/d_slavonia.txt"
Z4B = "countries/d_smaland.txt"
Z4C = "countries/d_socotra.txt"
Z4D = "countries/d_somogy.txt"
Z4E = "countries/d_suhma.txt"
Z4F = "countries/d_syrte.txt"
Z4G = "countries/d_tadmekka.txt"
Z4H = "countries/d_taizz.txt"
Z4I = "countries/d_takrur.txt"
Z4J = "countries/d_tamasna.txt"
Z4K = "countries/d_tannu_ola.txt"
Z4L = "countries/d_temes.txt"
THS = "countries/Thessaloniki.txt"
Z4N = "countries/d_thessaly.txt"
THC = "countries/Thrakesia.txt"
Z4P = "countries/d_togina.txt"
Z4Q = "countries/d_toledo.txt"
Z4R = "countries/d_tondai_nadu.txt"
Z4S = "countries/d_tosali.txt"
Z4T = "countries/d_turgay.txt"
Z4U = "countries/d_turnovo.txt"
Z4V = "countries/d_turov.txt"
Z4W = "countries/d_tuyuhun.txt"
Z4X = "countries/d_uda_valley.txt"
Z4Y = "countries/d_udayagiri.txt"
Z4Z = "countries/d_udmurtia.txt"
Z50 = "countries/d_ungvar.txt"
Z51 = "countries/d_upper_silesia.txt"
Z52 = "countries/d_ural.txt"
Z53 = "countries/d_urdunn.txt"
Z54 = "countries/d_vanga.txt"
Z55 = "countries/d_varendra.txt"
Z56 = "countries/d_vaspurakan.txt"
Z57 = "countries/d_vastergotland.txt"
Z58 = "countries/d_vengi.txt"
Z59 = "countries/d_vidin.txt"
Z5A = "countries/d_visegrad.txt"
Z5B = "countries/d_volga_bulgaria.txt"
Z5C = "countries/d_wagadu.txt"
Z5D = "countries/d_warangal.txt"
Z5E = "countries/d_wasit.txt"
Z5F = "countries/d_west_franconia.txt"
Z5G = "countries/d_xigaze.txt"
Z5H = "countries/d_xining.txt"
Z5I = "countries/d_yamama.txt"
Z5J = "countries/d_yijinai.txt"
VRK = "countries/Everwick.txt"
Z5L = "countries/d_zabulistan.txt"
Z5M = "countries/d_zadoi.txt"
Z5N = "countries/d_zanskar.txt"
Z5O = "countries/d_zaragoza.txt"
Z5P = "countries/d_zhetysu.txt"
Z5Q = "countries/c_aargau.txt"
Z5R = "countries/c_adanse.txt"
Z5S = "countries/c_adrianopolis.txt"
Z5T = "countries/c_agadir.txt"
Z5U = "countries/c_agairik.txt"
Z5V = "countries/c_agdeside.txt"
Z5W = "countries/c_aguleri.txt"
Z5X = "countries/c_ahaggar.txt"
Z5Y = "countries/c_ahqaf.txt"
Z5Z = "countries/c_ain_azawa.txt"
Z60 = "countries/c_ain_galakka.txt"
Z61 = "countries/c_akkel.txt"
Z62 = "countries/c_al-asa.txt"
Z63 = "countries/c_al-haditha.txt"
Z64 = "countries/c_al-hasa.txt"
Z65 = "countries/c_aley.txt"
Z66 = "countries/c_algeciras.txt"
Z67 = "countries/c_almader.txt"
Z68 = "countries/c_almeria.txt"
Z69 = "countries/c_altay.txt"
Z6A = "countries/c_amhara.txt"
Z6B = "countries/c_amiens.txt"
Z6C = "countries/c_andujar.txt"
Z6D = "countries/c_angermanland.txt"
Z6E = "countries/c_angot.txt"
Z6F = "countries/c_angus.txt"
Z6G = "countries/c_anioma.txt"
Z6H = "countries/c_annaba.txt"
Z6I = "countries/c_antipatreia.txt"
Z6J = "countries/c_antwerpen.txt"
Z6K = "countries/c_aowin.txt"
Z6L = "countries/c_apa.txt"
Z6M = "countries/c_apahunik.txt"
Z6N = "countries/c_aqqa.txt"
Z6O = "countries/c_aqtobe.txt"
Z6P = "countries/c_aran.txt"
Z6Q = "countries/c_arbanon.txt"
Z6R = "countries/c_arkat.txt"
Z6S = "countries/c_aror.txt"
Z6T = "countries/c_arusi.txt"
Z6U = "countries/c_ashir.txt"
Z6V = "countries/c_ashmaka.txt"
Z6W = "countries/c_askedal.txt"
Z6X = "countries/c_astana.txt"
Z6Y = "countries/c_astorga.txt"
Z6Z = "countries/c_aswan.txt"
Z70 = "countries/c_asyut.txt"
Z71 = "countries/c_atbasar.txt"
Z72 = "countries/c_atholl.txt"
Z73 = "countries/c_attie.txt"
Z74 = "countries/c_atyrau.txt"
Z75 = "countries/c_austisland.txt"
Z76 = "countries/c_avalois.txt"
Z77 = "countries/c_aviovara.txt"
Z78 = "countries/c_avlonas.txt"
Z79 = "countries/c_avranches.txt"
Z7A = "countries/c_awjila.txt"
Z7B = "countries/c_awssa.txt"
Z7C = "countries/c_azov.txt"
Z7D = "countries/c_azrou.txt"
Z7E = "countries/c_baalbek.txt"
Z7F = "countries/c_babruysk.txt"
Z7G = "countries/c_badakhshan.txt"
Z7H = "countries/c_badghis.txt"
Z7I = "countries/c_badis.txt"
Z7J = "countries/c_baghaya.txt"
Z7K = "countries/c_baguirmi.txt"
Z7L = "countries/c_bahnasa.txt"
Z7M = "countries/c_baigaluuls.txt"
Z7N = "countries/c_baisary.txt"
Z7O = "countries/c_bakharz.txt"
Z7P = "countries/c_balachev.txt"
Z7Q = "countries/c_balgun.txt"
Z7R = "countries/c_bam.txt"
Z7S = "countries/c_bambuk.txt"
Z7T = "countries/c_bamian.txt"
Z7U = "countries/c_bampur.txt"
Z7V = "countries/c_bandiagara.txt"
Z7W = "countries/c_baninko.txt"
Z7X = "countries/c_banre.txt"
Z7Y = "countries/c_baol.txt"
Z7Z = "countries/c_baqen.txt"
Z80 = "countries/c_barbacadle.txt"
Z81 = "countries/c_bardak.txt"
Z82 = "countries/c_barma.txt"
Z83 = "countries/c_barnaul.txt"
Z84 = "countries/c_barqa.txt"
Z85 = "countries/c_basagha.txt"
Z86 = "countries/c_bassa.txt"
Z87 = "countries/c_bauchi.txt"
Z88 = "countries/c_baydhabo.txt"
Z89 = "countries/c_beaumont.txt"
Z8A = "countries/c_behabad.txt"
Z8B = "countries/c_beja.txt"
Z8C = "countries/c_belebey.txt"
Z8D = "countries/c_belogorje.txt"
Z8E = "countries/c_belz.txt"
Z8F = "countries/c_bena.txt"
Z8G = "countries/c_benavente.txt"
Z8H = "countries/c_benghazi.txt"
Z8I = "countries/c_berbera.txt"
Z8J = "countries/c_berent.txt"
Z8K = "countries/c_berestye.txt"
Z8L = "countries/c_berlin.txt"
Z8M = "countries/c_besancon.txt"
Z8N = "countries/c_beshbalik.txt"
Z8O = "countries/c_betpa.txt"
Z8P = "countries/c_bhera.txt"
Z8Q = "countries/c_bida.txt"
Z8R = "countries/c_biia.txt"
Z8S = "countries/c_bilizma.txt"
Z8T = "countries/c_bindugu.txt"
Z8U = "countries/c_biram.txt"
Z8V = "countries/c_bisha.txt"
Z8W = "countries/c_biskra.txt"
Z8X = "countries/c_biu_kagha.txt"
Z8Y = "countries/c_biun.txt"
Z8Z = "countries/c_blois.txt"
Z90 = "countries/c_bodele.txt"
Z91 = "countries/c_bonduku.txt"
Z92 = "countries/c_bono.txt"
Z93 = "countries/c_bonoso.txt"
Z94 = "countries/c_bornu.txt"
Z95 = "countries/c_boro_burgasu.txt"
Z96 = "countries/c_bothin.txt"
Z97 = "countries/c_boubo.txt"
Z98 = "countries/c_bouillon.txt"
Z99 = "countries/c_bouna.txt"
Z9A = "countries/c_bratsk.txt"
BRY = "countries/Brycheiniosig.txt"
Z9C = "countries/c_breisgau.txt"
Z9D = "countries/c_brescia.txt"
Z9E = "countries/c_bresse.txt"
Z9F = "countries/c_brie_francaise.txt"
Z9G = "countries/c_briey.txt"
Z9H = "countries/c_brno.txt"
Z9I = "countries/c_brzeg.txt"
Z9J = "countries/c_bugurslan.txt"
Z9K = "countries/c_bulsa.txt"
Z9L = "countries/c_bundu.txt"
Z9M = "countries/c_bur.txt"
Z9N = "countries/c_bura.txt"
Z9O = "countries/c_burgos.txt"
Z9P = "countries/c_busaso.txt"
Z9Q = "countries/c_bussa.txt"
Z9R = "countries/c_cabra.txt"
Z9S = "countries/c_cadiz.txt"
Z9T = "countries/c_cairo.txt"
Z9U = "countries/c_calafat.txt"
Z9V = "countries/c_calatayud.txt"
Z9W = "countries/c_calatrava.txt"
Z9X = "countries/c_cambray.txt"
Z9Y = "countries/c_cammin.txt"
Z9Z = "countries/c_canarias.txt"
ZAF = "countries/Zafunu.txt"
ZAN = "countries/Swahili.txt"
ZAP = "countries/Zapotec.txt"
ZAZ = "countries/Zaporozhie.txt"
ZIM = "countries/Mutapa.txt"
ZND = "countries/Zandoma.txt"
ZNI = "countries/Zuni.txt"
ZUL = "countries/Zulu.txt"
ZUN = "countries/Zunghar.txt"
ZZZ = "countries/Zazzau.txt"
AKL = "countries/Akilineq.txt"
POV = "countries/Powoa ek Farsym.txt"
CNT = "countries/Cantabria.txt"
SUV = "countries/Suevia.txt"
AMZ = "countries/Amazonia.txt"
BMR = "countries/Al-Bimaral.txt"
CSV = "countries/Cousinville.txt"
AFP = "countries/Africa Proconsularis.txt"
APM = "countries/Ap Madoc.txt"
APO = "countries/Ap Otywa.txt"
PLD = "countries/Paludes.txt"
CTW = "countries/Cantwareburh.txt"
OXF = "countries/Oxnaford.txt"
SSX = "countries/Suthseaxe.txt"
HWC = "countries/Hwicce.txt"
WHT = "countries/Wihtwara.txt"
MNW = "countries/Meonwara.txt"
GAU = "countries/Gallia.txt"
RHU = "countries/Rhuma.txt"
"countries/CreateCountryForm.txt" 
JRS = "countries/Jersey.txt"
SRK = "countries/Sark.txt"
GUE = "countries/Guernsey.txt"
ALD = "countries/Alderney.txt"
SPO = "countries/Sporades.txt"
CYC = "countries/Cyclades.txt"
DDC = "countries/Dodecanese.txt"
